9 9 9 9 9 9 9 9 9 9
9 3 3 3 1 1 1 1 1 9
9 3 4 3 1 1 1 1 1 9
9 3 3 3 1 1 1 1 1 9
9 1 1 1 1 1 1 1 1 9
9 1 1 1 1 1 1 1 1 9
9 1 1 1 1 8 5 5 5 9
9 1 1 1 1 1 5 6 5 9
9 1 1 1 1 1 5 5 5 9
9 9 9 9 9 9 9 9 9 9
