7 7 7 7 7 7 7 7 7 7
7 3 3 3 1 1 1 1 1 7
7 3 4 3 1 1 1 1 1 7
7 3 3 3 1 1 1 1 1 7
7 1 1 1 1 1 1 1 1 7
7 1 1 1 1 1 1 1 1 7
7 1 1 1 1 8 5 5 5 7
7 1 1 1 1 1 5 6 5 7
7 1 1 1 1 1 5 5 5 7
7 7 7 7 7 7 7 7 7 7
